#############################
#@ #          #     #      #
#   # ######### #######  ####
#   #       #       # #   # #
### # ##### ######### # # # #
#         #         # # # # #
# ####### ######### # # # # #
# #     # #       # # # # # #
# # ### # # ##### # # # # # #
# # #   # #     # # # # #   #
# # ### # ##### # # # ##### #
# #   # #       # # #       #
# ### # ####### # # ####### #
#   # #         # #       # #
### # ######### # ####### # #
#   #       #   #         # #
##### ##### # ########### # #
#       #       #       # # #
####### # ####### ##### # # #
#       #         #   # #   #
# ######### # ##### # # #####
#           #              D
#############################

