#####################################
# @#                    #           #
# #   ####### ####### ##### ####### #
#   #     #       #       #   #     #
### ### ### ##### # ##### # # # # # #
#   #   #   #     # #   #   # # # # #
# # ### # ### ####### # ### # # # # #
# #   # #     #     #     #     #   #
# # ######### # ### ####### ####### #
#   #         #   # #     # #       #
### # ########### # # ### # # #######
#   #         #   # #     # # #     #
# # ####### ### ### ####### # ##### #
# #   #   #   # #     #   #       # #
# ####### # ##### ### # ####### # # #
# #     # # #     #   # #     # #   #
# ### ### # ##### ####### ### # #####
#   # #     #         #   # #   #   #
### # ####### ####### # # # # # ### #
#   #     #     #     # # #     # # #
# ####### # ### # ####### ######### #
#   #     #     # #       #         #
### # ####### ### ####### ### ##### #
#   #     #   #       # #     # #   #
# ####### # # ####### # ##### # ## ##
#       #   #   #   #     #   #    D
#########################################
